....................
.....LL.............
...........LL.......
....................
.....LLLLLLLL.......
....................
LLLLLLLLLLLLLLLLLLLL
