....................
.....LLLLLLL........
.....L.....LL.......
.....LLLLLLLL.......
.....LLLLLLLL.......
.....LL...LL........
LLLLLLLLLLLLLLLLLLLL