....................
..LLLL......LLL.....
.......LLL..........
...............L.L..
....................
....................