....................
..4000......000.....
.......000......0...
.......0.......400..
......000.......0...
.......000..........
30..0000000100000002