L..................L
L.LLLL......LLL....L
L......LLL..........
...............LLL.L
L...LL..............
....................
LLLLLLLLLLLLLLLLLLLL