....................
.0...2...00...2...0.
...0...0....0...0...
.4...0...10...0...4.
....................
.030..030..030..030.
....................