0..................0
0.......0..0.......0
0.......0..0.......0
0......00..00......0
0.....000..000.....0
0..000000..000000..0
010000000..000000030