....................
..LLL.......LLL.....
.........LLL........
....................
....LLL..LLL.....LLL
....................
LLLLLLLLLLLLLLLLLLLL