....................
....................
.....0001000........
.2...0.....00.....2.
..0000000000000000..
.....00000000.......
.....00...00........